NO ./textures/arbre_north.png
SO ./textures/arbre_south.png
WE ./textures/arbre_west_2.png
EA ./textures/arbre_east_2.png
F 175,225,14
C 0,255,222


1111111111111111111
100000000111000S001
1000000001110000001
1010101011110101011
1010101011110101011
1010101011110101011
1010101011110101011
1110111011110111011
1110111011110111011
1100001111110111011
1100001111111111011
1110111111111111011
1112111111111111111
