NO ./textures/arbre_north.png
SO ./textures/arbre_south.png
WE ./textures/arbre_west_2.png
EA ./textures/arbre_east_2.png
F 175,225,14
C 0,255,222



111111111111111111
11000000110101S111
100000111111000001
100000000000000011
110000011101010111
11110111 1110101
11112111 1111111 
